##############################################
# Explain:                                   #
# 	Grid: 26 * 26                            #
# 	Grid SIZE: 24 * 24 pixels                #
#   S: Space      B: Brick      I: Iron      #
#   R: River1/2   C: Ice        T: Tree      #
##############################################
%TOTALENEMYNUM:12
%MAXENEMYNUM:6
%HOMEPOS:12,24
%HOMEAROUNDPOS:11,23 12,23 13,23 14,23 11,24 14,24 11,25 14,25
%PLAYERTANKPOS:0,24 24,24
%ENEMYTANKPOS:0,0 12,0 24,0
S S S S S S S S S S S S S S S S S S S S S S S S S S
S S S S S S S S S S S S S S S S S S S S S S S S S S
S S B B S S B B S S B B S S B B S S B B S S B B S S
S S B B S S B B S S B B S S B B S S B B S S B B S S
S S B B S S B B S S B B S S B B S S B B S S B B S S
S S B B S S B B S S B B S S B B S S B B S S B B S S
S S B B S S B B S S B B I I B B S S B B S S B B S S
S S B B S S B B S S B B I I B B S S B B S S B B S S
S S B B S S B B S S B B S S B B S S B B S S B B S S
S S B B S S B B S S S S S S S S S S B B S S B B S S
S S B B S S B B S S S S S S S S S S B B S S B B S S
S S S S S S S S S S R R R R R R S S S S S S S S S S
S S S S S S S S S S R R R R R R S S S S S S S S S S
S S S S C C C C S S S S S S S S S S C C C C S S S S
I I S S C C C C S S S S S S S S S S C C C C S S I I
S S S S S S S S S S B B S S B B S S S S S S S S S S
S S S S S S S S S S B B B B B B S S S S S S S S S S
S S B B S S B B S S B B B B B B S S B B S S B B S S
S S B B S S B B S S B B S S B B S S B B S S B B S S
S S B B S S B B S S B B S S B B S S B B S S B B S S
S S B B S S B B S S B B S S B B S S B B S S B B S S
S S B B S S B B S S S S S S S S S S B B S S B B S S
S S B B S S B B S S S S S S S S S S B B S S B B S S
S S B B S S B B S S S I I I I S S S B B S S B B S S
S S S S S S S S S S S I S S I S S S S S S S S S S S
S S S S S S S S S S S I S S I S S S S S S S S S S S